****************************************************************************
*              #                                                           *
*************************************** ************************************
*                              *                 *                         *
*                                                                          *
*                              *                 *                         *
*********************************************************** ****************
*                                                                          *
****************************************************************************